*P************************************************
* *** **        ***      *************************
*  ** ** *** ** *** **** *************************
**  * ** *** ** *** **** *************************
*** * ** *** ** *** **** *************************
*** * ** *** ** *** ****                         T
*** * ** *** ** *** ******* **********************
*** * ** *** ** *** *     * *****   **************
*** * ** *** ** *** * ** **   *** * **************
*** * ** *** ** *** * *  ** ***** * **************
*** * ** *** ** *** * **  *  **** * **************
*** * ** *** ** *** * *  ** ***** * **************
*** * ** *** ** *** * **  *   *** * **************
*** * ** *** ** *** * *  ** ***** * **************
*** * ** *** ** *** * **  *  **** * **************
*** * ** *** ** *** * *  ** ***** * **************
*** * ** *** ** *** * **  *       * **************
*** * ** *** ** *** * *  ** *** * * **************
*** * ** *** ** *** * **  *  ** * * **************
*** * ** *** ****** * *  ** *** * * **************
*** * ** *** ****** * ** **   * * * **************
***      ***        *       *** * * **************
**************************************************