**************************************************
*                    *                           *
*********** ********** ************************* * 
P                      ************************* *
********************** ************************* *
*   *   *   *   *      *                  ****** *
* * * * * * * * * * ** * **************** ****** *
* * * * * * * * * * ** * **************** ****** *       
* * * * * * * * * * ** * **************** ****** *       
* * * * * * * * * * ** * **************** ****** *        
* * * * * * * * * * ** * **************** ****** *      
* * * * * * * * * * ** * **************** ****** *        
* * * * * * * * * * **                    ****** *
* * * * * * * * * * ** * ****** **************** *
* * * * * * * * * * ** * ******     ************ *
* * * * * * * * * * ** * **********    ********* *
* * * * * * * * * * ** * *************    ****** *
* * * * * * * * * * ** * **************** ****** *
* * * * * * * * * * ** * **************** ****** *
* * * * * * * * * * ** * **************** ****** *
* * * * * * * * * * ** * **************** ****** *
T *   *   *   *   *    ************************* *
**************************************************